12 12
-
1 0
-
6 7 7 7 7 7 7 7 7 7 7 8
16 4 4 4 4 1 4 4 4 2 4 18
11 2 4 2 4 1 1 2 1 4 1 13
16 2 4 2 4 1 1 2 4 2 4 18
11 2 4 4 4 1 1 2 1 2 4 13
16 1 1 4 2 4 2 4 4 2 4 18
11 1 2 4 1 4 1 4 1 4 4 13
16 4 2 4 4 4 4 2 4 2 4 18
11 1 1 4 1 4 1 4 1 4 1 13
16 1 4 4 4 4 4 2 1 2 2 18
11 4 1 2 1 1 1 4 4 1 1 13
21 22 22 22 22 22 22 22 22 22 22 23
-
2 1
-
6 7 7 7 7 7 7 7 7 7 7 8
11 3 3 3 3 3 3 2 2 2 2 13
16 3 1 1 1 1 1 1 1 1 3 18
16 3 1 2 2 2 1 1 1 1 3 18
16 2 1 3 3 2 2 1 3 1 3 18
16 2 3 1 2 1 2 1 2 3 3 18
16 3 1 2 2 1 3 2 3 1 1 18
16 3 1 2 2 2 3 2 1 1 1 18
16 1 1 2 2 1 1 3 3 1 3 18
16 3 1 1 3 2 2 2 1 1 3 18
14 3 1 1 1 1 1 2 2 2 3 9
21 22 22 22 22 22 22 22 22 22 22 23
-
3 2
-
6 7 7 7 7 7 7 7 7 7 7 8
11 3 3 1 1 3 1 3 1 3 3 13
11 3 2 2 2 2 1 3 2 1 1 13
11 3 2 3 3 2 3 2 3 2 1 13
11 1 1 1 3 2 1 2 2 2 1 13
11 1 2 3 3 2 1 2 3 2 3 13
11 3 2 2 2 2 1 2 3 2 3 13
11 3 1 1 1 1 1 1 1 1 3 13
11 3 1 3 3 1 1 1 3 1 3 13
11 3 1 1 1 1 3 1 1 1 3 13
11 3 3 1 1 3 3 3 1 3 3 13
21 22 22 22 22 22 22 22 22 22 22 23
-
4 3
-
6 7 7 7 7 7 7 7 7 7 7 8
11 1 1 1 1 2 2 3 3 3 2 13
16 2 2 1 1 1 1 1 2 2 2 13
16 2 3 1 2 3 3 3 1 1 2 13
16 3 3 1 3 3 1 3 3 3 3 13
11 3 1 1 2 1 1 2 2 3 3 13
16 1 1 1 3 1 1 1 2 3 1 13
11 1 1 2 2 1 2 1 2 2 3 13
11 2 1 1 2 1 2 1 3 1 3 13
11 3 3 1 1 1 1 3 3 3 3 13
11 2 3 1 1 1 2 1 1 2 1 13
21 22 22 22 22 22 22 22 22 22 22 23